grasslands
AAGHIABABAAAAQBABXQXQAAAAAAAAAAAGHIABABAAAAQBABXQXQAAAAAAAAA
EEMHNEEEEEEEEEEEEEEEEEEEEEEEEEAAGHIABABAAAAQBABXQXQAAAAAAAAA
HHHHHHHHHHHHHHHHHHHHHHHHHHHHHHAAGHIABABAAAAQBABXQXQAAAAAAAAA
KKPHOKKKKKKKKKKKKKKKKKKKKKKKKKAAGHIABABAAAAQBABXQXQAAAAAAAAA
AAGHIABAAABAAAAAAABAAAAAABAAAAAAGHIABABAAAAQBABXQXQAAAAAAAAA
AAGHIAAABABAAAAAAAABAAAAAAAAABAAGHIABABAAAAQBABXQXQAAAAAAAAA
BAAAAAAAAAABAAABAAAAAAAAAAAAAAAAGHIABABAAAAQBABXQXQAAAAAAAAA
AAAAAAAAAAABAAABAAAAAAAAAAAAAAAAGHIABABAAAAQBABXQXQAAAAAAAAA
AAAAAAAAAAABAAABAAAAAAAAAAAAAAAAGHIABABAAAAQBABXQXQAAAAAAAAA
AAAAAAAAAAABAAABAAAAAAAAAAAAAAAAGHIABABAAAAQBABXQXQAAAAAAAAA
AADEFAAAAABAAAAAAAAAAAAAAAAAAAAAGHIABABAAAAQBABXQXQAAAAAAAAA
EEMHNEEEEEEEEEEEEEEEEEEEEEEEEEAAGHIABABAAAAQBABXQXQAAAAAAAAA
HHHHHHHHHHHHHHHHHHHHHHHHHHHHHHAAGHIABABAAAAQBABXQXQAAAAAAAAA
KKPHOKKKKKKKKKKKKKKKKKKKKKKKKKAAGHIABABAAAAQBABXQXQAAAAAAAAA
AAGHIAAABAAABAAAAAAAAAAAAAAAAAAAGHIABABAAAAQBABXQXQAAAAAAAAA
AAGHIAAABAAAAAABAAAAAABAAAAAAAAAGHIABABAAAAQBABXQXQAAAAAAAAA
AAGHIAABAABAAABAAAABAAAAAABAAAAAGHIABABAAAAQBABXQXQAAAAAAAAA
AAGHIAAABAAABAAAAAABABAAAAAAABAAGHIABABAAAAQBABXQXQAAAAAAAAA
AAGHIABAAABAAAAAAaQABBAAABAAABAAGHIABABAAAAQBABXQXQAAAAAAAAA
AAGHIAAABAAAAAABAAAAAAAAAABAAAAAGHIABABAAAAQBABXQXQAAAAAAAAA