grasslands
AAAAAAAAAAABAAABAAAAAAAAAAAAAA
AAAAAAAAAAABAAABAAAAAAAAAAAAAA
AAAAAAAAAAABAAABAAAAAAAAAAAAAA
AAAAAAAAAAABAAABAAAAAAAAAAAAAA
AADEFAAAAABAAAAAAAAAAAAAAAAAAA
EEMHNEEEEEEEEEEEEEEEEEEEEEEEEE
HHHHHHHHHHHHHHHHHHHHHHHHHHHHHH
KKPHOKKKKKKKKKKKKKKKKKKKKKKKKK
AAGHIAAABAAABAAAAAAAAAAAAAAAAA
AAGHIAAABAAAAAABAAAAAABAAAAAAA
AAGHIAABAABAAABAAAABAAAAAABAAA
AAGHIAAABAAABAAAAAABABAAAAAAAB
AAGHIABAAABAAAAAAaXXXBAAABAAAB
AAGHIAAABAAAAAABAXXXXAAAAABAAA
AAGHIABABAAAAQBABXXXXAAAAAAAAA
EEMHNEEEEEEEEEEEEEEEEEEEEEEEEE
HHHHHHHHHHHHHHHHHHHHHHHHHHHHHH
KKPHOKKKKKKKKKKKKKKKKKKKKKKKKK
AAGHIABAAABAAAAAAABAAAAAABAAAA
AAGHIAAABABAAAAAAAABAAAAAAAAAA