grasslands
BAAAAAAAAAABAAABAAAAAAAAAAAAAA
AAAAAAAAAAABAAABAAAAAAAAAAAAAA
AAAAAAAAAAABAAABAAAAAAAAAAAAAA
AAAAAAAAAAABAAABAAAAAAAAAAAAAA
AADEFAAAAABAAAAAAAAAAAAAAAAAAA
EEMHNEEEEEEEEEEEEEEEEEEEEEEEEE
HHHHHHHHHHHHHHHHHHHHHHHHHHHHHH
KKPHOKKKKKKKKKKKKKKKKKKKKKKKKK
AAGHIAAABAAABAAAAAAAAAAAAAAAAA
AAGHIAAABAAAAAABAAAAAABAAAAAAA
AAGHIAABAABAAABAAAABAAAAAABAAA
AAGHIAAABAAABAAAAAABABAAAAAAAB
AAGHIABAAABAAAAAAaQABBAAABAAAB
AAGHIAAABAAAAAABAAAAAAAAAABAAA
AAGHIABABAAAAQBABXQXQAAAAAAAAA
EEMHNEEEEEEEEEEEEEEEEEEEEEEEEE
HHHHHHHHHHHHHHHHHHHHHHHHHHHHHH
KKPHOKKKKKKKKKKKKKKKKKKKKKKKKK
AAGHIABAAABAAAAAAABAAAAAABAAAA
AAGHIAAABABAAAAAAAABAAAAAAAAAB