grasslands
BAQQQAAAAAABAAABAAAAAAAAAAAAAA
AAQQQAAAAAABAAABAAAAAAAAAAAAAA
AAQQQAAAAAABAAABAAAAAAAAAAAAAA
AAQQQAAAAAABAAABAAAAAAAAAAAAAA
AADEFAAAAABAAAAAAAAAAAAAAAAAAA
EEMHNEEEEEEEEEEEEEEEEEEEEEEEEE
HHHHHHHHHHHHHHHHHHHHHHHHHHHHHH
KKPHOKKKKKKKKKKKKKKKKKKKKKKKKK
AAGHIAAABAAABAAAAAAAAAAAAAAAAA
AAGHIAAABAAAAAABAAAAAABAAAAAAA
AAGHIAABAABAAABAAAABAAAAAABAAA
AAGHIAAABAAABAAAAAABABAAAAAAAB
AAGHIABAAABAAAAAAAQABBAAABAAAB
AAGHIAAABAAAAAABAAAAAAAAAABAAA
AAGHIABABAAAAQBABBQQQAAAAAAAAA
EEMHNEEEEEEEEEEEEEEEEEEEEEEEEE
HHHHHHHHHHHHHHHHHHHHHHHHHHHHHH
KKPHOKKKKKKKKKKKKKKKKKKKKKKKKK
AAGHIABAAABAAAAAAABAAAAAABAAAA
AAGHIAAABABAAAAAAAABAAAAAAAAAB