AAAAAAAAAAABAAABAAAAAAAAAAAAAA
AAAAAAAAAAABAAABAAAAAAAAAAAAAA
AAAAAAAAAAABAAABAAAAAAAAAAAAAA
AAAAAAAAAAABAAABAAAAAAAAAAAAAA
AADEFAAAAABAAAAAAAAAAAAAAAAAAA
EEMHNEEEEEEEEEEEEEEEEEEEEEEEEE
HHHHHHHHHHHHHHHHHHHHHHHHHHHHHH
KKPHOKKKKKKKKKKKKKKKKKKKKKKKKK
AAGHIAAABAAABAAAAAAAAAAAAAAAAA
AAGHIAAABAAAAAABAAAAAABAAAAAAA
AAGHIAABAABAAABAAAABAAAAAABAAA
AAGHIAAABAAABAAAAAABABAAAAAAAB
AAGHIABAAABAAAAAAAAAABAAABAAAB
AAGHIAAABAAAAAABAAAAAAAAAABAAA
AAGHIABABAAAAQBABAAAAAAAAAAAAA
EEMHNEEEEEEEEEEEEEEEEEEEEEEEEE
HHHHHHHHHHHHHHHHHHHHHHHHHHHHHH
KKPHOKKKKKKKKKKKKKKKKKKKKKKKKK
AAGHIABAAABAAAAAAABAAAAAABAAAA
AAGHIAAABABAAAAAAAABAAAAAAAAAA