16 16 16 16 16 16 16 16 16 16 16 16 16 16 38 16 16 16 16 16 16 16 16 16 20 21 22 16 16 16 16 16 16 16 16 16 16 16 16 16 16 16 16 16 16 16 16 16 16 16 
16 16 16 16 16 16 16 16 16 16 16 16 16 16 38 19 19 19 19 19 19 19 19 19 20 21 22 19 19 19 16 16 16 16 16 16 16 16 16 16 16 16 16 16 16 16 16 16 16 16 
16 16 16 16 16 16 16 16 16 16 16 19 19 19 38 19 19 19 19 17 19 19 18 19 20 21 22 19 19 19 19 19 19 16 16 16 16 16 16 16 16 16 16 16 16 16 16 16 16 16 
16 16 16 16 16 16 16 16 16 19 19 19 17 19 38 19 19 64 18 17 19 19 64 19 20 21 22 19 18 64 19 19 17 19 19 19 19 16 16 16 16 16 16 16 16 16 16 16 16 16 
16 16 16 16 16 16 16 16 16 19 64 19 17 19 38 19 19 19 19 19 19 19 19 19 20 21 22 19 19 17 18 19 64 19 122 19 18 122 19 18 16 16 16 16 16 16 16 16 16 16 
16 16 16 16 16 16 16 16 19 19 18 19 19 19 38 19 19 19 19 19 19 19 19 18 20 21 22 19 17 17 18 18 19 19 124 17 19 124 19 19 19 17 16 16 16 16 16 16 16 16 
16 16 16 16 16 16 16 19 19 18 18 19 19 19 96 39 39 39 39 77 19 18 19 19 20 21 22 19 19 17 19 19 19 111 103 112 112 104 123 19 17 19 83 19 83 17 83 17 16 16 
16 16 16 16 16 16 19 19 19 18 19 19 19 19 19 19 19 19 19 38 19 19 19 17 20 21 22 19 19 19 19 18 19 105 103 115 117 104 118 19 19 17 19 17 19 19 19 19 16 16 
16 16 16 16 16 19 19 19 19 19 19 19 18 18 18 19 17 19 19 38 19 19 19 17 20 21 22 19 18 19 19 18 19 103 103 101 113 104 104 19 18 19 19 19 19 17 19 17 16 16 
16 16 16 16 16 19 19 17 19 19 19 19 19 19 19 19 64 19 19 38 64 19 19 19 20 21 22 19 19 64 19 19 19 19 16 20 22 19 19 17 19 67 27 7 27 7 27 68 16 16 
16 16 16 16 19 19 19 64 19 19 12 13 13 14 19 19 19 19 19 38 19 18 19 18 20 21 22 18 17 19 19 19 19 19 16 20 22 88 88 88 88 88 88 88 88 88 88 88 16 16 
16 16 16 16 19 19 19 19 19 19 125 33 33 34 14 6 7 7 8 38 19 19 19 19 20 21 22 19 17 19 19 18 19 19 16 20 22 88 88 88 88 88 88 88 88 88 88 88 16 16 
16 16 16 16 19 19 19 156 155 157 52 74 74 54 54 87 84 84 87 38 19 19 64 19 20 21 22 19 17 19 19 19 19 19 16 20 22 16 19 19 19 17 19 18 18 19 19 16 16 16 
16 16 16 16 18 19 19 158 159 160 52 53 72 54 54 86 88 88 86 38 19 19 19 19 20 21 22 19 19 19 64 19 19 19 16 20 22 16 19 19 19 64 19 19 19 19 19 16 16 16 
16 16 16 19 19 19 19 0 1 1 1 1 1 1 1 1 1 1 1 55 1 1 1 1 81 21 22 19 19 19 18 19 19 19 16 20 22 16 19 19 18 18 19 19 19 19 19 16 16 16 
16 16 16 19 19 18 64 20 21 21 21 21 21 21 21 21 21 21 21 21 21 21 21 21 21 21 22 19 19 18 19 19 18 19 16 20 22 16 19 19 19 19 19 19 17 18 19 16 16 16 
16 16 16 16 19 19 19 40 41 41 41 41 41 41 41 41 41 41 41 75 41 41 41 41 61 21 22 19 17 19 19 19 19 19 19 20 22 19 19 19 19 18 19 19 64 19 19 16 16 16 
16 16 16 16 18 19 19 19 19 19 19 19 19 19 19 3 4 4 4 95 5 19 19 19 20 21 22 19 64 19 19 18 19 19 19 20 22 19 19 19 17 19 19 19 19 145 19 19 16 16 
16 16 16 16 16 17 19 19 17 17 18 64 19 3 4 99 24 24 24 24 25 19 18 19 20 21 22 19 18 19 19 19 64 19 19 20 22 19 64 18 17 19 19 18 146 147 148 19 16 16 
16 16 16 16 16 16 18 19 17 19 19 19 19 23 24 24 24 24 24 24 25 19 64 19 20 21 22 19 19 19 18 18 17 17 19 20 22 19 19 19 19 18 19 18 149 150 151 19 16 16 
16 16 16 16 126 16 16 16 19 19 19 19 19 23 24 24 24 24 78 44 45 19 17 19 20 21 22 19 19 19 19 19 19 17 19 20 22 19 19 19 19 17 17 19 152 153 154 19 16 16 
16 16 16 127 128 129 16 16 16 19 19 19 19 43 79 24 24 78 45 19 64 19 17 19 20 21 22 19 64 19 17 19 17 17 19 20 22 19 18 18 19 64 19 19 88 88 88 19 16 16 
16 16 16 130 131 132 16 16 16 19 19 19 18 19 43 44 44 45 19 18 19 18 17 19 20 21 22 19 18 19 19 19 18 19 19 20 22 19 19 19 19 19 18 88 88 88 19 18 16 16 
16 16 16 17 88 17 16 16 16 16 19 19 19 19 19 19 64 19 19 19 19 19 19 19 20 21 22 19 19 19 64 19 19 19 19 20 22 19 19 19 19 19 88 88 88 19 19 19 16 16 
1 1 1 1 1 1 1 1 1 1 1 1 1 1 1 1 1 1 1 1 1 1 1 1 81 21 80 1 1 1 1 1 1 1 1 81 80 1 1 1 1 1 1 1 1 1 1 1 1 1 
21 21 21 21 21 21 21 21 21 21 21 21 21 21 21 21 21 21 21 21 21 21 21 21 21 21 21 21 21 21 21 21 21 21 21 21 21 21 21 21 21 21 21 21 21 21 21 21 21 21 
41 41 41 41 41 41 41 41 41 41 41 41 41 41 41 41 41 41 41 41 41 41 41 41 61 21 60 41 41 41 41 41 41 41 41 41 41 41 41 41 41 41 41 41 41 41 41 41 41 41 
16 19 19 19 19 19 19 19 19 19 19 19 19 19 88 19 19 19 19 19 18 19 19 19 20 21 22 64 19 19 19 19 19 19 19 19 19 19 19 19 19 19 18 19 19 19 19 19 16 16 
16 19 19 19 19 19 18 19 19 19 19 64 19 88 18 19 19 19 19 19 19 19 19 19 20 21 22 19 19 19 18 19 19 64 19 19 19 19 19 19 19 19 19 19 19 19 19 19 16 16 
16 19 19 18 19 126 19 19 19 126 19 19 19 19 88 6 7 7 9 90 10 10 11 18 20 21 22 19 19 19 19 19 19 19 18 19 19 17 19 19 18 19 19 19 19 19 19 19 16 16 
16 19 19 19 127 128 129 17 127 128 129 19 18 88 19 26 144 88 29 30 30 30 31 19 20 21 22 19 19 18 19 19 166 167 168 19 17 17 178 179 180 19 19 64 18 19 19 16 16 16 
16 19 19 19 130 131 132 19 130 131 132 17 88 88 19 86 88 88 49 143 50 69 51 19 20 21 22 19 19 18 19 19 169 170 171 172 173 174 181 182 183 19 17 19 19 19 19 16 16 16 
16 133 134 135 17 19 19 62 19 88 19 17 88 19 88 88 19 88 0 1 1 1 1 1 81 21 22 19 19 19 19 17 161 19 161 175 176 177 161 19 162 19 19 19 19 19 16 16 16 16 
16 136 137 138 17 19 62 142 62 19 88 88 19 19 19 19 19 88 40 41 41 41 41 41 61 21 22 19 19 19 64 19 163 164 165 161 19 162 163 164 165 19 19 18 19 16 16 16 16 16 
16 139 140 141 19 19 18 62 19 19 19 64 19 19 19 18 19 19 19 19 19 19 19 19 20 21 22 19 19 19 17 18 19 88 88 163 164 165 88 88 18 19 19 19 19 16 16 16 16 16 
16 16 19 19 19 17 19 19 19 19 17 17 17 19 19 19 19 19 64 19 19 19 19 19 20 21 22 19 19 19 19 19 19 88 88 88 88 88 88 88 19 19 19 19 16 16 16 16 16 16 
16 16 19 19 19 17 19 19 18 19 19 19 17 19 19 19 19 19 19 19 19 19 19 19 20 21 22 19 19 19 19 19 19 17 88 88 88 88 88 19 19 19 19 16 16 16 16 16 16 16 
16 16 16 19 19 3 4 4 4 4 4 5 19 19 19 18 19 19 18 18 19 18 19 19 20 21 22 19 19 19 17 18 19 17 88 88 65 88 88 19 19 19 16 16 16 16 16 16 16 16 
16 16 16 3 4 99 24 24 24 24 24 98 4 5 17 17 19 19 64 19 19 19 19 19 20 21 22 19 19 19 17 88 88 88 88 88 85 88 88 19 19 16 16 16 16 16 16 16 16 16 
16 3 4 99 24 24 24 24 24 24 24 24 24 24 5 19 19 19 19 19 19 19 19 19 20 21 22 88 88 88 88 88 88 88 88 88 88 88 19 19 19 16 16 16 16 16 16 16 16 16 
3 99 24 24 24 24 24 24 24 24 24 24 24 24 24 5 19 18 19 19 19 19 19 19 20 21 22 88 88 88 88 88 88 88 88 88 19 19 19 19 16 16 16 16 16 16 16 16 16 16 
24 24 24 24 24 24 24 24 24 24 24 24 24 24 24 98 5 19 19 19 19 17 19 19 20 21 22 88 88 88 88 88 19 17 19 19 19 19 19 19 16 16 16 16 16 16 16 16 16 16 
24 24 24 24 24 24 24 24 24 24 24 24 24 24 24 24 24 5 19 19 64 17 19 19 20 21 22 19 19 17 17 19 19 64 18 19 19 19 19 16 16 16 16 16 16 16 16 16 16 16 
24 24 24 24 24 24 24 24 24 24 24 24 24 24 24 24 24 25 19 19 17 19 19 19 20 21 22 19 19 19 19 19 19 19 19 19 19 19 16 16 16 16 16 16 16 16 16 16 16 16 
24 24 24 24 24 24 24 24 24 24 24 24 24 24 24 24 24 25 19 19 19 19 19 19 20 21 22 19 19 19 18 19 19 19 19 19 16 16 16 16 16 16 16 16 16 16 16 16 16 16 
24 24 24 24 24 24 24 24 24 24 24 24 24 24 24 24 24 25 18 19 18 19 19 19 20 21 22 19 19 19 19 19 19 19 19 16 16 16 16 16 16 16 16 16 16 16 16 16 16 16 
24 24 24 24 24 24 24 24 24 24 24 24 24 24 24 24 24 98 5 19 19 19 19 19 20 21 22 19 19 19 19 19 16 16 16 16 16 16 16 16 16 16 16 16 16 16 16 16 16 16 
24 24 24 24 24 24 24 24 24 24 24 24 24 24 24 24 24 24 25 19 19 19 16 16 20 21 22 16 16 16 16 16 16 16 16 16 16 16 16 16 16 16 16 16 16 16 16 16 16 16 
24 24 24 24 24 24 24 24 24 24 24 24 24 24 24 24 24 24 25 16 16 16 16 16 20 21 22 16 16 16 16 16 16 16 16 16 16 16 16 16 16 16 16 16 16 16 16 16 16 16 
24 24 24 24 24 24 24 24 24 24 24 24 24 24 24 24 24 24 25 16 16 16 16 16 20 21 22 16 16 16 16 16 16 16 16 16 16 16 16 16 16 16 16 16 16 16 16 16 16 16 
