16 16 16 16 16 16 16 16 16 16 16 16 16 16 38 16 16 16 16 16 16 16 16 16 20 21 22 16 16 16 16 16 16 16 16 16 16 16 16 16 16 16 16 16 16 16 16 16 16 16 
16 16 16 16 16 16 16 16 16 16 16 16 16 16 38 19 19 19 19 19 19 19 19 19 20 21 22 19 19 19 16 16 16 16 16 16 16 16 16 16 16 16 16 16 16 16 16 16 16 16 
16 16 16 16 16 16 16 16 16 16 16 19 19 19 38 19 19 19 19 17 19 19 18 19 20 21 22 19 19 19 19 19 19 16 16 16 16 16 16 16 16 16 16 16 16 16 16 16 16 16 
16 16 16 16 16 16 16 16 16 19 19 19 17 19 38 19 19 64 18 17 19 19 64 19 20 21 22 19 18 64 19 19 17 19 19 19 19 16 16 16 16 16 16 16 16 16 16 16 16 16 
16 16 16 16 16 16 16 16 16 19 64 19 17 19 38 19 19 19 19 19 19 19 19 19 20 21 22 19 19 17 18 19 64 19 122 19 19 122 19 19 16 16 16 16 16 16 16 16 16 16 
16 16 16 16 16 16 16 16 19 19 18 19 19 19 38 19 19 19 19 19 19 19 19 18 20 21 22 19 17 17 18 18 19 19 124 19 19 124 19 19 19 19 16 16 16 16 16 16 16 16 
16 16 16 16 16 16 16 19 19 18 18 19 19 19 96 39 39 39 39 77 19 18 19 19 20 21 22 19 19 17 19 19 19 111 103 112 112 104 123 83 19 83 16 16 16 16 16 16 16 16 
16 16 16 16 16 16 19 19 19 18 19 19 19 19 19 19 19 19 19 38 19 19 19 17 20 21 22 19 19 19 19 18 19 105 103 115 117 104 118 19 19 19 19 16 16 16 16 16 16 16 
16 16 16 16 16 19 19 19 19 19 19 19 18 18 18 19 17 19 19 38 19 19 19 17 20 21 22 19 18 19 19 18 19 103 103 101 113 104 104 19 19 19 19 19 19 16 16 16 16 16 
16 16 16 16 16 19 19 17 19 19 19 19 19 19 19 19 64 19 19 38 64 19 19 19 20 21 22 19 19 64 19 19 19 19 16 20 22 19 67 27 7 27 68 19 19 16 16 16 16 16 
16 16 16 16 19 19 19 64 19 19 12 13 13 14 19 19 19 19 19 38 19 18 19 18 20 21 22 18 17 19 19 19 19 19 16 20 22 88 88 88 88 88 19 19 64 19 16 16 16 16 
16 16 16 16 19 19 19 19 19 19 125 33 33 34 14 6 7 7 8 38 19 19 19 19 20 21 22 19 17 19 19 18 19 19 16 20 22 19 19 19 19 19 19 19 19 19 16 16 16 16 
16 16 16 19 19 19 19 18 19 19 52 53 53 54 54 87 84 84 87 38 19 19 64 19 20 21 22 19 17 19 19 19 19 19 16 20 22 16 19 19 19 19 19 18 18 19 19 16 16 16 
16 16 16 19 18 19 19 19 19 19 52 74 72 54 54 86 88 88 86 38 19 19 19 19 20 21 22 19 19 19 64 19 19 19 16 20 22 16 19 19 19 64 19 19 19 19 19 16 16 16 
16 16 19 19 19 19 19 19 19 19 0 1 1 1 1 1 1 1 1 55 1 1 1 1 81 21 22 19 19 19 18 19 19 19 16 20 22 16 19 19 18 18 19 19 19 19 19 16 16 16 
16 16 19 19 19 18 64 19 18 19 20 21 21 21 21 21 21 21 21 21 21 21 21 21 21 21 22 19 19 18 19 19 18 19 16 20 22 16 19 19 19 19 19 19 17 18 19 16 16 16 
16 16 19 19 19 19 19 19 19 19 40 41 41 41 41 41 41 41 41 75 41 41 41 41 61 21 22 19 17 19 19 19 19 19 19 20 22 19 19 19 19 18 19 19 64 19 19 16 16 16 
16 16 19 19 18 19 19 19 19 19 19 19 19 19 19 3 4 4 4 95 5 19 19 19 20 21 22 19 64 19 19 18 19 19 19 20 22 19 19 19 17 19 19 19 19 19 19 19 16 16 
16 16 19 19 17 17 19 19 17 17 18 64 19 3 4 99 24 24 24 24 25 19 18 19 20 21 22 19 18 19 19 19 64 19 19 20 22 19 64 18 17 19 19 18 19 19 19 19 16 16 
16 19 19 17 17 19 18 19 17 19 19 19 19 23 24 24 24 24 24 24 25 19 64 19 20 21 22 19 19 19 18 18 17 17 19 20 22 19 19 19 19 18 19 18 19 18 19 19 16 16 
16 19 19 64 19 19 19 19 19 19 19 19 19 23 24 24 24 24 78 44 45 19 17 19 20 21 22 19 19 19 19 19 19 17 19 20 22 19 19 19 19 17 17 19 19 19 17 19 16 16 
16 19 18 19 18 19 19 19 9 10 11 19 19 43 79 24 24 78 45 19 64 19 17 19 20 21 22 19 64 19 17 19 17 17 19 20 22 19 18 18 19 64 19 19 64 19 17 19 16 16 
16 19 19 19 19 64 19 19 29 30 31 19 18 19 43 44 44 45 19 18 19 18 17 19 20 21 22 19 18 19 19 19 18 19 19 20 22 19 19 19 19 19 18 19 19 19 19 18 16 16 
16 19 19 19 19 19 19 16 49 69 51 16 19 19 19 19 64 19 19 19 19 19 19 19 20 21 22 19 19 19 64 19 19 19 19 20 22 19 19 19 19 19 19 19 19 19 19 19 16 16 
1 1 1 1 1 1 1 1 1 1 1 1 1 1 1 1 1 1 1 1 1 1 1 1 81 21 80 1 1 1 1 1 1 1 1 81 80 1 1 1 1 1 1 1 1 1 1 1 1 1 
21 21 21 21 21 21 21 21 21 21 21 21 21 21 21 21 21 21 21 21 21 21 21 21 21 21 21 21 21 21 21 21 21 21 21 21 21 21 21 21 21 21 21 21 21 21 21 21 21 21 
41 41 41 41 41 41 41 41 41 41 41 41 41 41 41 41 41 41 41 41 41 41 41 41 61 21 60 41 41 41 41 41 41 41 41 41 41 41 41 41 41 41 41 41 41 41 41 41 41 41 
16 19 19 19 19 19 19 19 19 19 19 19 19 19 19 19 19 19 19 19 18 19 19 19 20 21 22 64 19 19 19 19 19 19 19 19 19 19 19 19 19 19 18 19 19 19 19 19 16 16 
16 19 19 19 19 19 18 19 19 19 19 64 19 19 18 19 19 19 19 19 19 19 19 19 20 21 22 19 19 19 18 19 19 64 19 19 19 19 19 19 19 19 19 19 19 19 19 19 16 16 
16 19 19 18 19 19 19 19 19 18 19 19 19 19 19 19 17 17 9 10 10 10 11 18 20 21 22 19 19 19 19 19 19 19 18 19 19 17 19 19 18 19 19 19 19 19 19 19 16 16 
16 19 19 19 19 19 64 17 17 19 19 19 18 19 19 17 19 19 29 30 30 30 31 19 20 21 22 19 19 18 19 19 19 19 19 19 17 17 19 18 19 19 19 64 18 19 19 16 16 16 
16 19 19 19 17 19 19 19 19 19 19 17 17 19 19 64 19 19 49 71 50 69 51 19 20 21 22 19 19 18 19 19 18 19 19 64 19 19 19 19 19 19 17 19 19 19 19 16 16 16 
16 18 19 19 17 19 19 18 19 19 19 17 19 19 19 19 19 19 0 1 1 1 1 1 81 21 22 19 19 19 19 17 19 19 19 18 19 19 19 19 19 19 19 19 19 19 16 16 16 16 
16 19 19 19 17 19 19 19 19 19 19 18 18 19 19 19 19 19 40 41 41 41 41 41 61 21 22 19 19 19 64 19 19 19 19 19 19 18 19 19 19 19 19 18 19 16 16 16 16 16 
16 19 19 64 19 19 18 19 19 19 19 64 19 19 19 18 19 19 19 19 19 19 19 19 20 21 22 19 19 19 17 18 19 19 19 19 19 19 19 64 18 19 19 19 19 16 16 16 16 16 
16 16 19 19 19 17 19 19 19 19 17 17 17 19 19 19 19 19 64 19 19 19 19 19 20 21 22 19 19 19 19 19 19 19 19 18 19 19 17 17 19 19 19 19 16 16 16 16 16 16 
16 16 19 19 19 17 19 19 18 19 19 19 17 19 19 19 19 19 19 19 19 19 19 19 20 21 22 19 19 19 19 19 19 17 17 19 19 19 17 19 19 19 19 16 16 16 16 16 16 16 
16 16 16 19 19 19 19 19 18 19 19 19 19 19 19 18 19 19 18 18 19 18 19 19 20 21 22 19 19 19 17 18 19 17 19 19 19 19 18 19 19 19 16 16 16 16 16 16 16 16 
16 16 16 16 19 19 19 64 19 19 19 18 19 17 17 17 19 19 64 19 19 19 19 19 20 21 22 19 19 19 17 17 19 19 19 19 19 19 19 19 19 16 16 16 16 16 16 16 16 16 
16 16 16 16 16 19 19 19 18 19 19 19 19 19 19 19 19 19 19 19 19 19 19 19 20 21 22 19 19 19 64 19 19 19 19 18 19 19 19 19 19 16 16 16 16 16 16 16 16 16 
16 16 16 16 16 19 19 19 18 19 19 19 19 19 19 19 19 18 19 19 19 19 19 19 20 21 22 19 19 18 19 19 19 19 19 19 19 19 19 19 16 16 16 16 16 16 16 16 16 16 
16 16 16 16 16 16 16 19 19 19 19 19 19 64 18 19 19 19 19 19 19 17 19 19 20 21 22 19 19 19 19 19 19 17 19 19 19 19 19 19 16 16 16 16 16 16 16 16 16 16 
16 16 16 16 16 16 16 16 19 19 18 19 19 19 19 19 19 19 19 19 64 17 19 19 20 21 22 19 19 17 17 19 19 64 18 19 19 19 19 16 16 16 16 16 16 16 16 16 16 16 
16 16 16 16 16 16 16 16 16 19 19 19 19 19 17 17 19 19 19 19 17 19 19 19 20 21 22 19 19 19 19 19 19 19 19 19 19 19 16 16 16 16 16 16 16 16 16 16 16 16 
16 16 16 16 16 16 16 16 16 16 19 19 19 19 17 19 19 19 19 19 19 19 19 19 20 21 22 19 19 19 18 19 19 19 19 19 16 16 16 16 16 16 16 16 16 16 16 16 16 16 
16 16 16 16 16 16 16 16 16 16 16 16 19 19 18 19 19 19 18 19 18 19 19 19 20 21 22 19 19 19 19 19 19 19 19 16 16 16 16 16 16 16 16 16 16 16 16 16 16 16 
16 16 16 16 16 16 16 16 16 16 16 16 16 16 19 19 19 19 19 19 19 19 19 19 20 21 22 19 19 19 19 19 16 16 16 16 16 16 16 16 16 16 16 16 16 16 16 16 16 16 
16 16 16 16 16 16 16 16 16 16 16 16 16 16 16 19 19 64 19 19 19 19 16 16 20 21 22 16 16 16 16 16 16 16 16 16 16 16 16 16 16 16 16 16 16 16 16 16 16 16 
16 16 16 16 16 16 16 16 16 16 16 16 16 16 16 16 16 16 16 16 16 16 16 16 20 21 22 16 16 16 16 16 16 16 16 16 16 16 16 16 16 16 16 16 16 16 16 16 16 16 
16 16 16 16 16 16 16 16 16 16 16 16 16 16 16 16 16 16 16 16 16 16 16 16 20 21 22 16 16 16 16 16 16 16 16 16 16 16 16 16 16 16 16 16 16 16 16 16 16 16 
